type quad
height 6
width 8
map
TTTTTTTT
T......T
T..T...T
T..TTT.T
T...T..T
TTTTTTTT
