type octile
height 23
width 50
map
@@@@@@@@@@@@@@@@@@@@@@@@@@@@@@@@@@@@@@@@@@@@@@@@@@
@................................................@
@................................................@
@...................TTTTTTTTTTT..................@
@...................T.........T..................@
@...................T.........T..................@
@...................T.........T..................@
@...................T.........T..................@
@...................T.........T..................@
@...................T.........T..................@
@...................T.........T..................@
@...................T.........T..................@
@...................T.........T..................@
@...................T.........T..................@
@...................T.........T..................@
@...................T.........T..................@
@...................T.........T..................@
@...................T.........T..................@
@...................T.........T..................@
@................................................@
@................................................@
@................................................@
@@@@@@@@@@@@@@@@@@@@@@@@@@@@@@@@@@@@@@@@@@@@@@@@@@
