type octile
height 23
width 50
map
@@@@@@@@@@@@@@@@@@@@@@@@@@@@@@@@@@@@@@@@@@@@@@@@@@
@................................................@
@.......TTTTTTTTTTTTTTTTTTTTTTTTTTTT.............@
@.......T..........................T.............@
@.......T..........................T.............@
@.......T..........................T.............@
@.......T..........................T.............@
@.......T..........................T.............@
@.......T..........................T.............@
@.......T..........................T.............@
@.......T..........................T.............@
@..................................T.............@
@.......T..........................T.............@
@.......T..........................T.............@
@.......T..........................T.............@
@.......T..........................T.............@
@.......T..........................T.............@
@.......T..........................T.............@
@.......T..........................T.............@
@.......TTTTTTTTTTTTTTTTTTTTTTTTTTTT.............@
@................................................@
@................................................@
@@@@@@@@@@@@@@@@@@@@@@@@@@@@@@@@@@@@@@@@@@@@@@@@@@
