type octile
height 23
width 50
map
@@@@@@@@@@@@@@@@@@@@@@@@@@@@@@@@@@@@@@@@@@@@@@@@@@
@................................................@
@................................................@
@................................................@
@................................................@
@................................................@
@................................................@
@................................................@
@........TTTTTTTTTTTTTTTTTTTTTT..................@
@........T....................T..................@
@........T....................T..................@
@.............................T..................@
@.............................T..................@
@........T....................T..................@
@........T....................T..................@
@........TTTTTTTTTTTTTTTTTTTTTT..................@
@................................................@
@................................................@
@................................................@
@................................................@
@................................................@
@................................................@
@@@@@@@@@@@@@@@@@@@@@@@@@@@@@@@@@@@@@@@@@@@@@@@@@@
