type octile
height 23
width 50
map
@@@@@@@@@@@@@@@@@@@@@@@@@@@@@@@@@@@@@@@@@@@@@@@@@@
@....................T................T..........@
@....................T....T...........T..........@
@....................T....T...........T..........@
@....................T....T...........T..........@
@....................T....T...........T..........@
@....................T....T...........T..........@
@....................T....T...........T..........@
@....................T....T...........T..........@
@.........................T......................@
@........TTTTTTTTTTTTTTTTTTTTTTTTTTTTTTTTTTTT...T@
@........T....................T..................@
@........TTTT.TTTTTTTTTTTTTTTTT..................@
@...........T.T....T.T........T..................@
@TTTTTTTTTT.T.T....T.T........T..................@
@.............T....T.T........T..................@
@TTTTTTTT.TTTTT....T.T........T..................@
@.......T.T........T.T........T..................@
@.......T.T........T.T........T..................@
@.......T.T........T.T........T..................@
@TTTTTTTT.TTTTTTTTTT.TTTTTTTTTT..................@
@.............................T..................@
@@@@@@@@@@@@@@@@@@@@@@@@@@@@@@@@@@@@@@@@@@@@@@@@@@
