type octile
height 23
width 50
map
@@@@@@@@@@@@@@@@@@@@@@@@@@@@@@@@@@@@@@@@@@@@@@@@@@
@.............................T..................@
@.............................T..................@
@.............................T..................@
@............T...................................@
@............T...................................@
@............T................T..................@
@............T................T..................@
@............T................T..................@
@................................................@
@................................................@
@...................T............................@
@....................T........T..................@
@.....................T.......T..................@
@..........T...........T......T..................@
@..........T............T.....T..................@
@..........T..................T..................@
@..........T..................T..................@
@..........T..................T..................@
@.............................T..................@
@.............................T..................@
@.............................T..................@
@@@@@@@@@@@@@@@@@@@@@@@@@@@@@@@@@@@@@@@@@@@@@@@@@@
